XXXXXXXXXXXXXX
XX XX        X
XX     X  X  X
X  X XXX XXX X
X  X  X  X   X
X  XX XX  XX X
X      XX  X X
X X  X X  XX X
X XX X  X XX X
X            X
XXXXXXXXXXXXXX
